-2,7,1
1,5,2,-90
3,5,2,-90
5,5,2,-90
7,5,2,-90
9,5,2,-90
11,5,2,-90
13,5,2,-90
15,5,2,-90
17,5,2,-90
19,5,2,-90
21,5,2,-90
23,5,2,-90
25,5,2,-90
27,5,2,-90
29,5,2,-90
31,5,2,-90
33,5,2,-90
35,5,2,-90